NO resources/badgeOnRedbricks.png
EA resources/greybricks.png
SO resources/greybricks.png
WE resources/figureOnWood.png

F 0,105,229
C 105,105,105

1111
0W0N
110E
S011
