NO resources/badgeOnRedbricks.png
EA resources/greybricks.png
SO resources/door.png
WE resources/figureOnWood.png

F 0,105,229
C 0,105,105

1111 111
00W00000
11001100
00110011
