NO resources/badgeOnRedbricks.png
EA resources/greybricks.png
SO resources/door.png
WE resources/figureOnWood.png

F 0,105,229
C 0,105,105

        1111111111111111111111111      
        1000000000000000000000001      
        1011000001110000000000001      
        1001000000000000000000001      
111111111011000001110000000000001      
100000000011000001110111111111111      
11110111111111011100000010001
11110111111111011101010010001
11111111110101011100000010001
       1000000001100000010001
       1000000001101010010001
       1110101011111011110N0111
11111111 1110101 101111010001
11111111 1111111 111111111111
