NO resources/badgeOnRedbricks.png
EA resources/greybricks.png
SO resources/greybricks.png
WE resources/figureOnWood.png

F -1,105,229
C 105,105,105

1111
00W0
1100
0011
