NO ./resources/crossOnWood.png
EA ./resources/crossOnWood.png
SO ./resources/crossOnWood.png
WE ./resources/crossOnWood.png

C 0,0,0
F 105,105,105

        1111111111111111111111111
        1000000000110000000000001
        1011000001110000000000001
        1001000000000000000000001
111111111011000001110000000000001
100N00000011000001110111111111111
11110111111111011100000010001
11110111111111011101010010001
11111111111111111111011111111
11000000110101011100000010001
10000000000000001100000000001
10000000000000001101010010001
1100000111010101111101111000111
11110111 1110101 101111010001
11111111 1111111 111111111111
