NO resources/badgeOnRedbricks.png
SO resources/door.png
EA resources/doorSlit.png
WE resources/doorSlit.png

C 255,0,0
F 1,20,20

11111111111111111111111111111
100000000000000000000000001
100000000100000000000000001
10000000010000000000000N001
100000000000000000000000001
111111111111111111111111111
